1111111111111111111111111111111111111111111111111111111111111111111111111111111111111111111111111111
1000000000000000000000000000000000000000000000000000000000000000000000000000000000000000000000000001
10ECP00000000000000000000000000000000000000000000000000000000000000000000000000000000000000000000001
1000000000000000000000000000000000000000000000000000000000000000000000000000000000000000000000000001
1000000000000000000000000000000000000000000000000000000000000000000000000000000000000000000000000001
1000000000000000000000000000000000000000000000000000000000000000000000000000000000000000000000000001
100000C00CC0CCC00C0CCCCCCCC000000CC0000C000C00C000CC0C0C0C0CC0CCCCCC0CC0CCCC00CC0CCCC0CC000CCCCC0C01
100000C00C0C0CC000CC00CC0C0C00CC0C000C0C00C000000CC00C00C00000CC0CCC00C0000C0C0CCCCCC0C0000C0CCC0CC1
100000000CC0CCC00C0CCCC0C00CC0CCC0CCCC0C0C00CC00CCCC0C0CC00C0CC00C000C0CCCC00CC0CC0C0CC0000C0CCC0001
100000CCCC00CCC00C00C0C00CC0C00C00C00CC000CC000C0C0C000C00CCCCC000C0CC0C00C0CC00000CCC0C00C0000CC0C1
100000CCC000CC0CCC0CCCCCC00C0CC0C00C00CCC0CC00CC00C0CCC0C000CC00C00C0C0C000C00C00C00000CCC00C0000CC1
100000C0C0C00C000C0CCC000CC0CCCCCC0C0C0C000C0C00C0CCCCCC0000C00CCC0C0000C00CC0000CC00C000CCCCC0C0CC1
10000000C0C0CCCCC0C00CCCC0C0CCCCC0000C0000C000CC0C000CCC000CCCCC0CC0C000CCC0CCC0CCC0C00C0C0CCCC00001
1000000C00C0CCCC00CC00C000C00C000000CC00C0000CC000C0CC00C00C0C0CCC0C0CCCC0CCC000C0C00CC00CC0C0CC00C1
10000000CC0CCCCC0CCC000CCC00C00CCCC000CCC00CCCCC0C000C0CCC0CCC00C00C0C0C0C0C0C000CC00000C0CCCC000CC1
10000000C00C00CC00CCC0CC00CCC0C0C00CCC0CCC00C00000C000CCC00C00C0CCC0000C0CCCC0CCCCCCC00CC0CC000000C1
100000C000CC00C00CCCCC0CCCC00C00CCC000C00C000C000CCCC0000CC0000C00CC0CCCC0C00CC00CC00CC000C00C000CC1
100000000CC00C0000C0C0C00CC0000CCC0C0CC000C000000CC000CCC0CCCC0C0C000CC00C0C0CCC0C00C00C0C0C0CCCC001
1000000CC0C000C0000C0CC0CCCCC00CC000C00C0C000CC00C0CC0CC000CC0CCCC0C0000CCCC0C0000CCCCC00CC0CC000CC1
100000C0CCC0C0000000C00CCCC00CCCCCC0000C0C00C000C0CCCC0C0CC000C0C0CCC00CCC0CCCC0CC00C0CC0C0000CC0C01
10000000CCC000CC0C0C0000CCCCC0000C0C00C0CCCCCCC00000CCC000CCC0CCCC000C0CC00C0000C0CCC0000000C0CC00C1
100000C00C0C00C00C0CCC0C00CC00CC0C0CCCCC0C0C000CC0CC00CC0C0C0C00CCCCCC0000C0CC0C0CCCC0CCC0000C0CCC01
100000C0CC0000CC000C0C0C000C0CCCC00CC00CCCC0C0C0CC000C000000C000CC0C0CC0CCCC00CCCCCC0C00CCCCC00CCC01
1000000000CC000000CC0CC0000C00C000C0CC00CC0CCCCC00CCC000CCCC0C0C00C0000C000C00CCCC0C0CC00C0CC0C000C1
100000CCC000CCC000CC0C00C0CC0CC0C0CC000CC0C00C00CCC0C0C0CCC000C0CC000000CCC0CC0C0C00C00000CC0000CC01
100000C0C0000CC0000000CCC0C0CC00C0000000C000CC0CC0CC0000C0CC000C0C00C0C0000CC00C0C0C00CC0CC0C0C00C01
100000C0000C000C0000CCC0C0C00000CC0C00000000C0CC00C00C000CC00000000CCCCCCCC000000000CCCC00000CC0C001
100000C0C0CC00CCCCCCCCCCC0C00000C000CCCCC00CC00C000C0000CC0000C00C0CC0CC00CC00CCCCC000CC0CC0CC000001
1000000000000000000000000000000000000000000000000000000000000000000000000000000000000000000000000001
1000000000000000000000000000000000000000000000000000000000000000000000000000000000000000000000000001
1000000000000000000000000000000000000000000000000000000000000000000000000000000000000000000000000001
1000000000000000000000000000000000000000000000000000000000000000000000000000000000000000000000000001
1000000000000000000000000000000000000000000000000000000000000000000000000000000000000000000000000001
1000000000000000000000000000000000000000000000000000000000000000000000000000000000000000000000000001
1000000000000000000000000000000000000000000000000000000000000000000000000000000000000000000000000001
1000000000000000000000000000000000000000000000000000000000000000000000000000000000000000000000000001
1000000000000000000000000000000000000000000000000000000000000000000000000000000000000000000000000001
1000000000000000000000000000000000000000000000000000000000000000000000000000000000000000000000000001
1000000000000000000000000000000000000000000000000000000000000000000000000000000000000000000000000001
1000000000000000000000000000000000000000000000000000000000000000000000000000000000000000000000000001
1000000000000000000000000000000000000000000000000000000000000000000000000000000000000000000000000001
1000000000000000000000000000000000000000000000000000000000000000000000000000000000000000000000000001
1000000000000000000000000000000000000000000000000000000000000000000000000000000000000000000000000001
1000000000000000000000000000000000000000000000000000000000000000000000000000000000000000000000000001
1000000000000000000000000000000000000000000000000000000000000000000000000000000000000000000000000001
1000000000000000000000000000000000000000000000000000000000000000000000000000000000000000000000000001
1000000000000000000000000000000000000000000000000000000000000000000000000000000000000000000000000001
1000000000000000000000000000000000000000000000000000000000000000000000000000000000000000000000000001
1000000000000000000000000000000000000000000000000000000000000000000000000000000000000000000000000001
1000000000000000000000000000000000000000000000000000000000000000000000000000000000000000000000000001
1000000000000000000000000000000000000000000000000000000000000000000000000000000000000000000000000001
1000000000000000000000000000000000000000000000000000000000000000000000000000000000000000000000000001
1000000000000000000000000000000000000000000000000000000000000000000000000000000000000000000000000001
1000000000000000000000000000000000000000000000000000000000000000000000000000000000000000000000000001
1000000000000000000000000000000000000000000000000000000000000000000000000000000000000000000000000001
1000000000000000000000000000000000000000000000000000000000000000000000000000000000000000000000000001
1000000000000000000000000000000000000000000000000000000000000000000000000000000000000000000000000001
1000000000000000000000000000000000000000000000000000000000000000000000000000000000000000000000000001
1000000000000000000000000000000000000000000000000000000000000000000000000000000000000000000000000001
1000000000000000000000000000000000000000000000000000000000000000000000000000000000000000000000000001
1000000000000000000000000000000000000000000000000000000000000000000000000000000000000000000000000001
1000000000000000000000000000000000000000000000000000000000000000000000000000000000000000000000000001
1000000000000000000000000000000000000000000000000000000000000000000000000000000000000000000000000001
1000000000000000000000000000000000000000000000000000000000000000000000000000000000000000000000000001
1000000000000000000000000000000000000000000000000000000000000000000000000000000000000000000000000001
1000000000000000000000000000000000000000000000000000000000000000000000000000000000000000000000000001
1000000000000000000000000000000000000000000000000000000000000000000000000000000000000000000000000001
1000000000000000000000000000000000000000000000000000000000000000000000000000000000000000000000000001
1000000000000000000000000000000000000000000000000000000000000000000000000000000000000000000000000001
1000000000000000000000000000000000000000000000000000000000000000000000000000000000000000000000000001
1000000000000000000000000000000000000000000000000000000000000000000000000000000000000000000000000001
1000000000000000000000000000000000000000000000000000000000000000000000000000000000000000000000000001
1000000000000000000000000000000000000000000000000000000000000000000000000000000000000000000000000001
1000000000000000000000000000000000000000000000000000000000000000000000000000000000000000000000000001
1000000000000000000000000000000000000000000000000000000000000000000000000000000000000000000000000001
1000000000000000000000000000000000000000000000000000000000000000000000000000000000000000000000000001
1000000000000000000000000000000000000000000000000000000000000000000000000000000000000000000000000001
1000000000000000000000000000000000000000000000000000000000000000000000000000000000000000000000000001
1000000000000000000000000000000000000000000000000000000000000000000000000000000000000000000000000001
1000000000000000000000000000000000000000000000000000000000000000000000000000000000000000000000000001
1000000000000000000000000000000000000000000000000000000000000000000000000000000000000000000000000001
1000000000000000000000000000000000000000000000000000000000000000000000000000000000000000000000000001
1000000000000000000000000000000000000000000000000000000000000000000000000000000000000000000000000001
1000000000000000000000000000000000000000000000000000000000000000000000000000000000000000000000000001
1000000000000000000000000000000000000000000000000000000000000000000000000000000000000000000000000001
1000000000000000000000000000000000000000000000000000000000000000000000000000000000000000000000000001
1000000000000000000000000000000000000000000000000000000000000000000000000000000000000000000000000001
1000000000000000000000000000000000000000000000000000000000000000000000000000000000000000000000000001
1000000000000000000000000000000000000000000000000000000000000000000000000000000000000000000000000001
1000000000000000000000000000000000000000000000000000000000000000000000000000000000000000000000000001
1000000000000000000000000000000000000000000000000000000000000000000000000000000000000000000000000001
1000000000000000000000000000000000000000000000000000000000000000000000000000000000000000000000000001
1000000000000000000000000000000000000000000000000000000000000000000000000000000000000000000000000001
1000000000000000000000000000000000000000000000000000000000000000000000000000000000000000000000000001
1000000000000000000000000000000000000000000000000000000000000000000000000000000000000000000000000001
1000000000000000000000000000000000000000000000000000000000000000000000000000000000000000000000000001
1000000000000000000000000000000000000000000000000000000000000000000000000000000000000000000000000001
1000000000000000000000000000000000000000000000000000000000000000000000000000000000000000000000000001
1000000000000000000000000000000000000000000000000000000000000000000000000000000000000000000000000001
1111111111111111111111111111111111111111111111111111111111111111111111111111111111111111111111111111